0;0;0;0;10;0;20;0;10;11;0;20;10;20;21;0
0;20;0;22;12;22;10;11;21;0;0;0;10;0;20;20
20;10;11;10;22;11;20;0;20;0;21;20;12;11;20;0
0;20;10;20;10;10;21;12;10;11;10;0;0;10;0;0
0;21;22;10;21;20;10;0;0;20;0;20;0;21;10;20
11;10;12;20;22;12;20;0;10;22;21;20;10;20;11;10
10;21;20;0;20;10;10;11;20;0;0;10;11;10;0;20
0;0;10;0;10;0;0;10;21;0;0;0;20;21;0;0
